#.#.#..#####.#.#.#.###.##.....###.##.#..###.####..#####..#....#..#..##..##
#..######.###...####..#..#####..##..#.#####...##.#.#..#.##..#.#......#.###
.######.###.####...#.##.##..#..#..#####.....#.#....###..#.##......#.....#.
.#..#..##..#...##.######.####.####.#.#...#.......#..#.#.#...####.##.#.....
.#..#...##.#.##..#...##.#.##..###.#......#.#.......#.#.#.####.###.##...#..
...####.#..#..#.##.#....##..#.####....##...##..#...#......#.#.......#.....
..##..####..#...#.#.#...##..#.#..###..#####........#..####......#...

#..#.
#....
##..#
..#..
..###